4 4 4 4 4 4 4 4 4 4 4 4 4 4 4 4
4 0 0 4 0 0 0 6 0 0 0 4 0 0 0 4
4 0 0 4 0 7 0 0 0 7 0 4 0 0 0 4
4 0 0 0 0 4 5 12 5 4 0 0 0 0 0 4
4 5 12 5 0 0 0 4 0 0 0 5 12 5 0 4
4 0 4 0 8 9 0 4 0 9 8 0 4 0 0 4
4 0 4 0 3 10 0 4 0 10 3 0 4 0 0 4
4 5 12 5 0 0 0 4 0 0 0 5 12 5 0 4
4 0 0 0 0 4 5 12 5 4 0 0 0 0 0 4
4 0 0 4 0 7 0 0 0 7 0 4 0 0 0 4
4 0 0 4 0 0 0 6 0 0 0 4 0 0 0 4
4 4 4 4 4 4 4 4 4 4 4 4 4 4 4 4
