4 4 4 4 4 4 4 4 4 4 4 4 4 4 4 4
4 0 1 0 0 4 6 7 6 4 0 0 1 0 0 4
4 0 0 0 0 0 0 0 0 0 0 0 0 0 0 4
4 0 0 5 0 0 12 12 12 0 0 5 0 0 0 4
4 5 0 0 0 12 0 5 0 12 0 0 0 5 0 4
4 0 0 11 0 5 0 5 0 5 0 11 0 0 0 4
4 0 0 10 0 5 0 5 0 5 0 10 0 0 0 4
4 5 0 0 0 12 0 5 0 12 0 0 0 5 0 4
4 0 0 5 0 0 12 12 12 0 0 5 0 0 0 4
4 0 0 0 0 0 0 0 0 0 0 0 0 0 0 4
4 0 1 0 0 4 6 7 6 4 0 0 1 0 0 4
4 4 4 4 4 4 4 4 4 4 4 4 4 4 4 4
