4 4 4 4 4 4 4 4 4 4 4 4 4 4 4 4
4 0 0 0 0 4 4 6 4 4 0 0 0 0 0 4
4 0 0 0 0 0 0 0 0 0 0 0 0 0 0 4
4 0 0 4 4 0 12 12 12 0 4 4 0 0 0 4
4 5 0 0 0 4 4 4 4 0 0 0 0 5 0 4
4 0 5 12 0 0 1 2 1 0 0 12 5 0 0 4
4 0 5 12 0 0 3 8 3 0 0 12 5 0 0 4
4 5 0 0 0 4 4 4 4 0 0 0 0 5 0 4
4 0 0 4 4 0 12 12 12 0 4 4 0 0 0 4
4 0 0 0 0 0 0 0 0 0 0 0 0 0 0 4
4 0 0 0 0 4 4 6 4 4 0 0 0 0 0 4
4 4 4 4 4 4 4 4 4 4 4 4 4 4 4 4
